__ __ __ __ __ __ __ __ __ __ __ __ __ __ __ __ __ __ __ __
__ __ __ __ __ __ __ __ __ __ __ __ __ __ __ __ __ __ __ __
__ __ WL WL WL WL WL __ __ __ __ __ __ WL WL WL WL WL __ __
__ __ WL __ U1 __ WL __ __ __ __ __ __ WL __ U4 __ WL __ __
__ __ WL __ T1 __ WL __ __ __ __ __ __ WL __ T4 __ WL __ __
__ __ WL __ R1 __ WL __ __ __ __ __ __ WL __ R4 __ WL __ __
__ __ WL WL __ WL WL __ __ __ __ __ __ WL WL __ WL WL __ __
__ __ __ __ __ __ __ __ __ __ __ __ __ __ __ __ __ __ __ __
__ __ __ __ __ __ __ __ __ __ __ __ __ __ __ __ __ __ __ __
__ __ __ __ __ __ __ __ __ __ __ __ __ __ __ __ __ __ __ __
__ __ __ __ __ __ __ __ __ __ __ __ __ __ __ __ __ __ __ __
__ __ __ __ __ __ __ __ __ __ __ __ __ __ __ __ __ __ __ __
__ __ __ __ __ __ __ __ __ __ __ __ __ __ __ __ __ __ __ __
__ __ WL WL __ WL WL __ __ __ __ __ __ WL WL __ WL WL __ __
__ __ WL __ R3 __ WL __ __ __ __ __ __ WL __ R2 __ WL __ __
__ __ WL __ T3 __ WL __ __ __ __ __ __ WL __ T2 __ WL __ __
__ __ WL __ U3 __ WL __ __ __ __ __ __ WL __ U2 __ WL __ __
__ __ WL WL WL WL WL __ __ __ __ __ __ WL WL WL WL WL __ __
__ __ __ __ __ __ __ __ __ __ __ __ __ __ __ __ __ __ __ __
__ __ __ __ __ __ __ __ __ __ __ __ __ __ __ __ __ __ __ __